111111111

1E00001C1
100100101
101010001
101P00011
111111111
111111111
