11111111111111111111
100000000000C0000001
1F0000000C00000000E1
10000P000000000C0001
11111111111111111111